
....................................................................
....................................................................
####################################################################
#..................................................................#
#..................................................................#
#..................................................................#
#..................................................................#
#..................................................................#
#..................................................................#
#..................................................................#
#..................................................................#
#..........##...........#######....................................#
#..........##......................................................#
#..........##......................................................#
#..........##......................................................#
...........##......................................................#
...................................................................#
#..................................................................#
#..................................................................#
#......................................########....................#
#..................................................................#
#..................................................................#
#..................................................................#
#..................................................................#
#..................................................................#
#..................................................................#
#...................................................................
#...................................................................
####################################################################

